###########################
#.........#.....#.........#
#.#####.#.#####.#########.#
#.#.....#...#...#.......#.#
#.#########.#.#.#.#####.#.#
#.......#...#.#.#.#...#.#.#
#########.###.#.#.###.###.#
#.#...........#.....#..A#.#
#.###.###.#.#####.#####.#.#
#.....#...#.....#.#.....#.#
#####.#.#########.#.###.#.#
#...#.#.#.#.......#.#...#.#
###.#.#.#.#.#.#####.#####.#
#.#.#.#...#.#...#.....#.#.#
#.#.#########.#.###.#.#.#.#
#.#.#.#.....#.#...#.#.#...#
#.#.#.#.#.#.#.#####.###.#.#
#.#...#.#.#.#...#...#...#.#
#.###.#.#.#####.#.###.###.#
#.#...#.#.......#.#...#...#
#.#.#.#.#.###.###.###.###.#
#.#.#...#.#.#...#.#...#.#.#
#.#######.#.#.#.#.#.###.#.#
#.........#.#.#.#.#.#...#.#
###########.#.#.#.###.#.#.#
#.............#.......#...#
###########################